+++++++++++++
+m  a b c  p+
+   +++++   +
+  t  Q  s  +
+d+  KIG  +j+
+ + OH2NE + +
+f+SL1 3FT+l+
+ + PC0AM + +
+e+  JBD  +k+
+  q  R  r  +
+   +++++   +
+n  g i h  o+
+++++++++++++
