blue: 0,A
cyan: 1,2,B
green: 3,4,C
orange: 5,D
+++++++++++++++++
+ 13 cbaddbc 42 +
+ +++++++++++++ +
+ +     +C+   + +
+c+     +C+   + +
+ +     +B+   + +
+ +     +B+   + +
+ +     +A+   + +
+ +     +D+   + +
+ +++++++D+++++ +
+      0c       +
+++++++++++++++ +
+5CC            +
+CC           cc+
+++++++++++++++++