blue: 0,A,D,F
red: 1,B,C,E
++++++++++
+0  +++ a+
+    F   +
+       b+
+A  ++++++
+        +
+ C +   B+
+   +    +
+ c  + d +
+ D  +   +
+   +  f +
+   +    +
+   +    +
+   + E  +
+  e     +
+       1+
+        +
+        +
+        +
+        +
+        +
+        +
+        +
+        +
++++++++++
