blue: 0,A,B,C,D,E,F,G,H,I,J,K,L,M
red: 1,N,O,P,Q,R,S,T,U,V,W,X,Y,Z
+++++++++++
+         +
+0+1+ + +t+
+A+N+ + +g+
+B+O+ + +s+
+C+P+ + +f+
+D+Q+ + +u+
+E+R+ + +h+
+F+S+ + +r+
+G+T+ + +e+
+H+U+ + +v+
+I+V+ + +i+
+J+W+ + +q+
+K+X+ + +d+
+L+Y+ + +w+
+M+Z+ + +j+
+++++++++p+
+++++++++c+
+++++++++x+
+++++++++k+
+++++++++o+
+++++++++b+
+++++++++y+
+++++++++l+
+++++++++n+
+++++++++a+
+++++++++z+
+++++++++m+
+++++++++++