+++++++++++++
+ +ba    B  +
+ +++       +
+           +
+           +
+           +
+           +
+           +
+           +
+           +
+       A   +
+         0 +
+++++++++++++
